1111111111111111111111111111111111111111111111111111111111111
1000000000000000000011111111111111110000000000000000000100001
1000000000000000000000000000000000000000000000000000000100001
1000000000000000000000000000000000000000000000000000000100001
1000000000000000000000000000000000000000000000000000000100001
1000000000000000000000000P00000000000000000000000000000100001
1000000000000000000000000000000000000000000000000000000100001
1000000000000000000000000000000000000000000000000000000100001
1000000000000000000000000000000000000000000000000000000100001
1000000000C00000000000000000000000000000000000000000000000001
1000000000000000000000000000000000000000000000000000000100001
1000000000000000000000000000000000000000000000000000000100001
10000000000000000000000000000000000E0000000000000000000100001
1000000000000000000000000000000000000000000000000000000100001
1000000000000000000000000000000000000000000000000000000100001
1111111111111111111111111111111111111111111111111111111111111