1111111111111
100C001000001
10PP00E0E0E01
1111111111111