1111111
1P01001
100C001
10E0001
1111111