111111111111111
100CCCC001C00E1
1P00C0000111101
1111111C0000001
11111111C111111
11111111C111111
11111111C111111
11111111C111111
111111111111111