111111111111111111111111
100000000000000000000001
1000000P0000010000000001
1CCC00100000001111110001
1111111E0000001000010001
100000000000001001010001
100000000000001111010001
100000000000000000010001
111111111111111111111111
