11111111111111111111111111111111111111111111111111111111111111111111111111
10100100001000001010000000000101111111111111111111111111111111111111111111
10011100101010100011110000000101111111111111111111111111111111111111111111
110111111111111C00001C0111111111111111111111111111111111111111111111111111
100000000C00C0000001E000000000000000000000000000000000000000000000000000C1
10000000000000000001110000000000000000000000000000000000000000000000000001
1P000000000000000000000000000000000000000000000000000000000000000000000001
10000000000000000000000000000000000000000000000000000000000000000000000001
10000000000000000000000C00000000000000000000000000000000000000000000000001
10000000000000000000000C00000000000000000000000000000000000000000000000001
10000000000000000000000C00000000000000000000000000000000000000000000000001
10000000000000000000000C00000000000000000000000000000000000000000000000001
10000000000000000000000C00000000000000000000000000000000000000000000000001
10000000000000000000000C00000000000000000000000000000000000000000000000001
10000000000000000000000C00000000000000000000000000000000000000000000000001
10000000000000000000000C00000000000000000000000000000000000000000000000001
10000000000000000000000C00000000000000000000000000000000000000000000000001
10000000000000000000000C00000000000000000000000000000000000000000000000001
10000000000000000000001111111000000000000000000000000000000000000000000001
10000000000000000000000C00001000000000000000000000000000000000000000000001
111111111111111C00001C0111111000000000000000000000000000000000000000000111
10100100001000001010000000000000000000000000000000000000000000000000000101
10111100101010100011110000000000000000000000000000000000000000000000000101
100000000C00C00000010000000000000000000000000000000000000000000000000000C1
10000000000000000001110000000000000000000000000000000000000000000000000001
10000000000000000000000000000000000000000000000000000000000000000000000001
10000000000000000000000000000000000000000000000000000000000000000000000001
10000000000000000000000C00000000000000000000000000000000000000000000000001
10000000000000000000000C00000000000000000000000000000000000000000000000001
10000000000000000000000C00000000000000000000000000000000000000000000000001
10000000000000000000000C00000000000000000000000000000000000000000000000001
10000000000000000000000C00000000000000000000000000000000000000000000000001
10000000000000000000000C00000000000000000000000000000000000000000000000001
10000000000000000000000C00000000000000000000000000000000000000000000000001
10000000000000000000000C00000000000000000000000000000000000000000000000001
10000000000000000000000C00000000000000000000000000000000000000000000000001
10000000000000000000000C00000000000000000000000000000000000000000000000001
10000000000000000000000C00000000000000000000000000000000000000000000000001
10000000000000000000001111111000000000000000000000000000000000000000000001
10000000000000000000000C00001000000000000000000000000000000000000000000001
11111111111111111111111111111111111111111111111111111111111111111111111111