1111111111111111111111111
100E0010000C0000C000000C1
100P00100C0000C00000C0001
1000C0100000C00000000C001
1011111000C0000C000C00001
10000000000C00000C00000C1
10000C0000F0000C000111111
1000000C00000C00011100C01
10000011111100C1110000001
1000111C0001111100C00f001
1C00000000C00000000000C01
1111111111111111111111111