1111111
1F00ff1
111C001
1P00E01
1111111