11111111
1PC10101
100000E1
11111111